barge - A large boat serving as an ancillary craft in the fishery from schooners; "Tie her up at the barge!"
batch - A qauntity of anything coming at a time; "I've got a fresh batch of bread on the way!"
beach - A level stretch of sea-worn rocks along the foreshore that was convient to use for drying and salting fish; "Go and dry those filets up on the beach!"
blank - An unsuccessful fishing season; "She was blank this year, caught nothing'"
blare - Of a cow, moose, etc, to low or bellow; "You should have heard the blare come out of that moose when she thought her calf was gone!"
blast - A quick burning fire fed by dried twigs or boughs; "Layer the splits right over the blast(y) boughs"
block - In lumbering,the area to be logged or cut; "We were lucky to get a bigger block than last season."
blood - A portion of cod flesh that adheres to the bone; "The blood of the cod is my favorite part!"
blush - *sheila's blush/brush is the firce storm that happens around St. Patrick's day; "You know sheila's brush is on the way, wear your parka to the pub!"
bough - The end of a branch terminating in twigs; "Blasyt boughs are the best for starting a fire!"
bride - *brides boys were the men who assisted for a wedding; "Tell those bride's boys to set that table up here!"
bring - *bring to During the winter, fishermen would 'bring them to' their nets by fitting them with new head and foot ropes; "I'll bring those nets too."
cabin - An often rustic dwelling meant for temporary occuation; "I loves to get out of town and into the cabin!"
capon - *caplin, capelan, capellin, caplain A small irrescent deep-water fish whose spawning was netted and used for food, bait and manure; "This terrible June weather just means the capon are rolling."
catch - Number of fish caugt; "How was the catch tody Skipper?"
chain - *chaining off a fishing operation connected with fishing in the ice on boats without hydraulic ice davits; "Chain off that warp!"
chair - *chair box Kitchen chair made out of a box or barrel; "Youngins sit on the chair boxes, save the proper chairs for Nan!"
charm - To cure an aliment by para-medical means; "Misses up the road will make you a poltice charm that will cure what ails ya."
cheek - Fleshy part of a cod's head; "There's nothing better than a feed of cod cheeks!"
chovy - *choby, copy, chuffy, shovy Pices of kindling wood shaved with a knife so the wood curls at the sides; "Shave off a bit of chovy so we can get the fire started."
chook - *chooky, chuck, chucky A call to pigs; "Chook, chook, chook....here's yer dinner!"
chaff - Bits of wood shavings and chips useful for starting fires; "make sure you use a fair bit of chaff since the wood is a tad damp."
civil - Calmer weather; "It's about time we had a bit of civil weather (usually not spoken until late June)."
clean - In logging, to fell the trees in a given cutting area; "This whole area is getting cleaned so we can build the cabin here."
cloth - cloth pudding: pudding made of flour and water, sometimes with raisins added, boiled in a cloth bag: duff; "I need a cloth bag for my figgy duff."
coach - *coach box A box for a passenger on a komatik; "She looks some comfy on the coach!"
coast - *costal fishery Cod fishery carried out in coastal waters; "We're called inshore harvesters because we fish just off the coast."
dally - Sudden lull or  slackeng of wind or a shift in the wind's direction; "Did you feel that dally?  Must be a storm brewing."
dandy - *dandy longlegs , daddy longlegs Very large flying insect that arrvied near summer's end. Also used as a name to call tall people; "I hate how the dandy longlegs feel when they touch my legs!"
darts - Another word for cigarettes. Also a quick visit or sudden movement; "Run up to the shop and grab me a pack of darts will ya?"
dicky - A wollen bib worn by children. Also a mock turtleneck; "Your white dicky under that sweater will look gorgeous!"
dirty - Resentful; "That's some dirty look she's giving him!"
dishy - *dishy looking A person looking pale or sickly in complexion; "Don't know why you're so sweet on him...sure he's right dishy!"
ditty - *ditties, diddies Nightmare; restlessness in one's sleep; "Some tired today...had the ditties all night."
dodge - To casually and slowly along, to saunter; "Let's dodge over to Lars for a custurd cone!"
every - *every way's likely: Anything can happen, even the unexpected; "It's every way's likely that you'll succeed!"
edger - A circular saw by which the bark is ripped fom slab-boards; "Use the edger to clean up those slabs."
egger - Person who plunders the nests of sea-birds for the eggs; "Keep watch for those eggers...always stealing the baby puffins!"
elson - *elisinor, elsanor A cap, oftern made of leather, with ear flaps; "Wear your elson to keep your ears warm!"
fairy - *fairy-struck mentally or physically harmed by the nafarious fairies who dwelled in the woods; "Make sure you're back before dark so the faires don't get you!"
figgy - *figgy duff pudding made with raisins and cooked in a bag; "Loves a good figgy duff after a feed of jigs!"
flash - A flexible strip of animal hide at the end of a dog-whip; "You'll get a trimming from the flash if you don't mind your manners!"
fleet - Two or more fishing nets strung together; "He uses fledts of three when he's fishing."
float - A lead weight forming part of a hook, used when fishing with a hand-line near the surface; "He uses a heavier float than most."
floor - In boat-building, a straight piece of wood used to join the body-frame timbers across the bottom of the craft; "You ewant to use the best slabs for the floor og her."
flood - *flood-gate: one of a number of openings on each side of a vessel permitting water to drain overboard from the deck; "Make sure you know where the flood gates are so you don't get swept overboard!"
fresh - The unsalted flesh of birds or animals eaten fresh."You never salt the fresh part of the cod!"
frost - *frostburn An injury of the flesh caused by exposure to freezing temperatures; "Make sure you're bundled up as tonight's temps cause frost-bite in minutes!"
gache - *gatch,gauch A person displaying swaggering behavior with a popmus gait is called a gatcher; "Look at the gacheon him...thinks he's all that!"
gaffs - To pull a fish from the water with a hook fastened to a short stick; "He uses the gaffs for grabbing the fish from the line."
glean - To laugh covertly; "We all glean when he says 'supurlative' instead of 'perogative'."
grand - *grand bank(s) A large area of shoal water southeast of Newfoundland forming a rich fishing-ground; "The grand banks have some of the world's greatest cod stocks."
grass - Mature hay ready to be dried for fodder; "We keeps the best fooder for the horses."
growl - A game of cards, sometimes known as 120; "She loves going 30 for 60 on nothing in a game of growl!"
gully - A small pond or series of linked ponds forming the head waters of a stream, or adjacent to a larger body of water; "I like to drop a line in the gully just past the main pond."
habit - Headress worn by Catholic nuns; "Sister Mary's habit is always perfect."
handy - Near by; close; "Don't go handy to those geese...they're some saucy!"
heart - The instep of a boot or shoe; "The heart is flexible so it'll be a better fit for your wide feet."
hoble - A job outside of one's usual work hours usually paid for using cash; "I got a hoble this weekend installing a hot water boiler for my Aunt."
hooky - Liable to snag or hook (an object); "Mind your sweater on that wall, she's all fulls of hooky splinters."
hovel - A shed for cattle or pigs; out-house of any kind; "We can't keep it in the house so put him out in the hovel!"
inner - Inshore, nearer the land; "We fish the inner part of the bay."
irish - Of Irish desent; "Her people are all Irish...just look at that red hair!"
jacky - Long-legs 'a large gnat'; "Watch those weeds...filled with the jacky!"
janny - Another word for a mummer; "Who's that janny over there with the apon on his head?"
jenny - Female harlequin duck; "Did you see how the lab went after that jenny?"
junky - Thick, chunky; "He's a little junky around the middle cause he likes a nip or two."
kedgy - *ketchie, kedgie A young boy taken on a ship to help with general duties; "I got my nephew on as kedgy this season."
keels - The game of ninepins, skittles or ball and hurley; "Come over after lunch and we'll have a gamw of keels."
labry - A narrow wooden covered walkway, often forming part of a network of passages, connecting different parts of a fishing stage; "We're putting up a new labry to join those two stages."
laggy - *leggy A small codfish, gutted, headed, salted and dried without being split; "One laggy is not enough to feed two people."
lammy - A short or three-quarter-length denim or leather coat, lined with sheep's or lamb's wool; "I got my misses a new lammy coat for Christmas...she'll look some sharpe!"
lassy - To spread (food) with molasses; "I loves a drop of lassy on my touton!"
leaky - Inflammation of hand or wrist caused by exposure to salt water; "That salt got my whole wrist gone leaky....some sore!"
leery - A short story told in great [circumstantial] detail; "He spins a good leery but you got to mind what he says."
licky - *lickery Of a conifer, esp fir, exuding resin or sap; "He likes to chew the licky of a fir."
light - *light-cured dried cod-fish prepared for market with application of minimum amount of salt; "I prefer light-cured cod for my fish and brewis." 
local - Ice formed in the bays and harbours; "Too many local growlers to get out today."
lodge - To place (an object) in a position; to set down on a surface; "Lodge that in right there!"
lolly - Soft ice forming in water; loose ice or snow floating in water; "The harbour is blocked with lolly today!"
loppy - Seas rough from wind or storm; "I wouldn't put a conoe out today misses, she's awful loppy!"
manus - The act of mutiny of a sealing crew; "All hands will go manus if we insist on staying out with no lassy on board."
mauzy - Damp, foggy, or misty weather sometimes with very light rain and a cool, gentle wind off the sea
merry - *merry dancers The northern lights, aurora borealis  
marry - To wed; "She's going to marry him next spring."
munge - To munch, chew; "Go have a munge of mom's homemade jerkey...she's deadly!"
natch - *notch, netch To cut notches in; to gash; "He tripped on the sidewalk and has a giant natch on his leg."
naked - An old, decayed, leafless tree; "Don't expect that tree to bloom, it's been naked for years."
nitch - *knitch A number of pieces of bark removed from spruce, birch or fir trees and carried on the shoulder; esp a bundle of ten pieces; "Grab that nitch of birch and bring it here will ya?"
noddy - To drag a heavy object on the ground; "Just noddy the dresser over to the lift."
nonia - The Newfoundland Outport Nursing and Industrial Association, known as Nonia, did pioneer work in providing nursing services for the outports; "The NONIA nurse is coming next week to check on me."
nunch - Snack taken between any of the main meals, esp in the woods or while fishing; "I gotta nice big sausage for a nunch t'day!"
ochre - A red type of the used by the Beothuk to paint their bodies, homes, canoes and weapons; "The Beothuks were sometimes called (*cringes) The Red Ochre Indians."
outer - Offshore, away from the land; "We fished on the outer part of the bay."
order - A term used to describe when a ship was prepared and ready; "The ship is in order Captain!"
patch - A group of seals; "There's a patch on that slab over there."
pease - One of three kinds of figgy duffs: a figgy one, a plain one and pease duff; "I'll have a pease duff instaed of a figgy with jiggs this Sunday."
pinch - A steep or difficult part of a road; "Make sure you slow down long before you get to that opinch before O'Reilly's house!"
pitch - To fall (from a height); "Mind the end so you dont't pitch and break something!"
pitty - *pitty-hole A grave parents threatened their naighty children with; "If you don't get in here right now, I allow you'll be put in the pitty-hole!"
poppy - An extract of the buds of the yellow pond-lily used as a home remedy; "Nan'll make you a poltice out of the poppy from the lilly-pads. It'll cure what ails ya."
porch - A room attached to a house, usually at the back, often adjoining the kitchen and used for various storage purposes
pooky - Shaped like a haycock
pound - To divide an enclosed space into compartments for storage; to partition
press - To place split and salted cod-fish in a 'pile' at various stages of the curing and drying process
prime - The codtrap berths were graded choice, prime, seconds, and fly, in that order
queak - The gentle squeak of the young of small animals
quiff - Man's soft felt hat with brim; fedora
quoit - To skip flat stones over the surface of the water
raise - To start or lead a tune
ramey - Thin, like a skeleton
randy - Boisterous play, esp a ride on a sled or in a vehicle or boat
rawny - Cloth that is flimsy  and threadbare
rhind - *rind, rine The bark of a tree or plant
rhode - *road, rode A rope for securing an anchor
rivel - To unweave, unravel
rough -  Turbulent weather with high-winds and heavy, drifting snow
rouse - To throw oneself with vigour and energy into an activity
rusty -  Second-year harp seals  are 'rusties,' or 'rusty jackets'
sabot - *sawboo Big, clumsy shoe or boot
sagger - A good boat-load of fish
sally - To move from side to side; to sway a boat
scabs - Workers who replace union workers during a labour disput; "Look at that bunch of scabs crossing the pickets line!"
scoff - A cooked meal at sea or ashore, esp at night and often part of an impromptu party
scrag - A disheveled or unkempt person, usually female; "Don't you go dating her, she's a scrag!"
scuff - A dance held at someone's house
scoop - A flat-bottomed wooden container with short handle used to bail water from a boat
scoot - A small vehicle used by children for sliding on snow
scout - Children's chasing game
scram - *scrawn, scran Scram-bag: canvas bag in which fisherman carries his day's food
scrap - A fight; "If he doesn't stop flirting with my misses, there's going to be a scrap
scrob - A scratch in one's flesh
shits - Unacceptable or undesirable; "This room is the shits!"
shack - In lumbering operations, to live in a small, roughly made dwelling; to cook and care for oneself in the 'lumber woods' or in a cheap dwelling
shaul - *shall, shaw To remove a husk
sheer - To swing a boat (by a length of rope) into a desired position
sheet - *sheet ice a stretch of flat, thin ice formed locaquented by seals
shift - To change one's clothing, boots, etc
shoal - A vessel having a shallow draught
shoot - To place or set a net or fishing line in position in the water
shuck - To slip down in the water
sieve - *cive, scyve A variety of small onion or onion-sprout
skate - To throw flat stones over the surface of water
snare - A wire device used for catching rabbit
soddy - Beneath proper size
sooky - Whining, petulant; jealous
souse - To go plunging in water
split - A thin piece of wood, about twelve to fourteen inches (30-36 cm) long, used chiefly as kindling
spicy - Attractive and slightly naughty
squat - To crush, bruise; squeeze; flatten
squid - To fish with or for squid
steam - To immerse (a plank, rail or timber) in steam in order to bend it into a desired curve or shape
steel - To sharpen a knife on a special steel rod
strap - To hoist an object on a vessel using a band of rope as a purchase for tackle
stump - To dress in shorter clothes
tabby - To jump from one floating ice-pan to another
taint - To remove hair from animal skins by storing in a warm, moist place for a few days
taker - In the game of marbles, a marble or ally pitched so close to that of an opponent that ownership can be claimed
tally - In keeping account of the number of seal pelts, dried cod, etc, being handled, the last of a sequence of numbers, esp five, forming a single group
tansy - The leaves of the common yarrow, an infusion of which is used in home-remedies and cooking
tatie - *tatey, teddy, tetty, tiddy, titty Potato
thawt - To lay (a thing) athwart or across
thick - Of the weather, with restricted visibility; dense with fog, mist, rain or snow
theif - Newfoundland grey jay
thorn - A spine or spiny process in an animal
tipsy - To jump from one floating ice-pan to another
tissy - Angry, irritable
torch - *torch night The night before Bonfire Night when it started to get dark you would see boys 10-15 years of age roaming the roads and lanes with torches lit
towny - A native of St John's, esp a male, usually derisive and contrasting with bay men
tramp - To walk clumsily, trample
trout - Fishing for trout
twack - To look at goods, inquire about prices, but make no purchase
uncle - Title of an older man, used with first or full name; general term of respect used of an older man in the community
wabby - A red-throated loon
watch - One of the groups of men on a sealing vessel 
water - To immerse split and salted cod in water in preparation for drying
watch - One of the groups of men on a sealing vessel 
young - Of various species of seal, designating an animal before breeding age
